x:19
y:19
0000000001000000000
0122222221222222210
0212222221222222120
0221222221222221220
0222122221222212220
0222212222222122220
0222221222221222220
0222222122212222220
0222222212122222220
1111112222222111111
0222222212122222220
0222222122212222220
0222221222221222220
0222212221222122220
0222122221222212220
0221222221222221220
0212222221222222120
0122222221222222210
0000000001000000000